+-+-+-+-+-+-+-+-+-+-+
|h  |   |      D  | |
+-+ +-+ + +-+-+ + + +
| |   | | |     |   |
+ + + + + + + +-+-+-+
|   | |   | | |     |
+-+-+ +-+ + + + +-+ +
|   | |   | |   |   |
+ + + + +-+ +-+-+ +-+
|P|     |       |   F
+-+-+-+-+-+-+-+-+-+-+